hemorrhage = kan kaybý
hematoma = kanýn doku içinde birikmesi kanama neticesiyle
lower exterimites = bacaklar 
upper extremities kollar 
supine = sýrt üstü
prone = yüz üstü
numb = hissizleþmek,uyuþmak
charred = kömürleþmiþ,kararmýþ
humidity = nem
fatigue = yorgunluk
nausea = mide bulantýsý
faint = baygýn
Agitation = ???
Convulsions = kaslarýn aniden istemsizce kasýlmasý
delirium = sayýklama
stool = feces = dýþký
pale = solgun
clammy skin = nemli ve soðuk deri
swelling = þiþme,þiþik
peripheral = çevresel
limb = uzuv (bacak,kol,...)
seiuzre = felç , inme
numbness = uyuþma
tingling = karýncalanma
deprived of oxygen = oksijene mahrum kalma(oksijen alamamasý)
clogged = týkanýk
edema = ödem
exposure = maruz kalma
shivering = titreme (soðukta titreriz hani)
inadequite = yeterisz
presence = varlýk
absence = yokluk
superficial = yüzeysel
debridement = yabancý maddenin yaradan uzaklaþtýrýlmasý
necrotic tissue = çürümüþ olan doku
demarcation = sýnýr çekme (amputationda)
nausea = mide bulantýsý
drowsiness = uyuþukluk , uykulu olma
dyspnia = nefes darlýðý
esophagus = yemek borusu
seizure = nöbet geçirme
compensatory = telafi edici
fatigue = yorgunluk
congestion = týkanýklýk
drive = dürtü
arousal = uyarýlma
innate = doðuþtan
esteem = saygý
intimacy = samimiyet
gland = salgý bezi 
arousing = harekete geçirmek
perspire = terlemek
